%%%%%%%%%%%%%%%%%%%%%
%..................R%
%.....%%%%......%%..%
%....%%..%%.....%%..%
%....%....%.........%
%...%%....%%....%%..%
%..........%....%%..%
%..%%%%%%%.%%...%%..%
%..%............%%..%
%.%%........%%..%%..%
%.%..........%..%%..%
%..................B%
%%%%%%%%%%%%%%%%%%%%%
