%%%%%%%%%%%%%%%%%%%%%%%%%%%%%%%%%%%%%%
%...................................B%
%.....%%%%.....%%%.......%.%.......%.%
%....%%  %%....%%%%......%.%.......%.%
%....%    %....%..%%.....%.%.......%.%
%...%%    %%...%...%%....%.%.......%.%
%...%      %...%....%%...%.%.......%.%
%..%%%%%%%%%%..%.....%%..%.%.......%.%
%..%........%..%......%%.%.%.......%.%
%.%%........%%.%.......%%%.%%.....%%.%
%.%..........%.%........%%..%%%%%%%..%
%...................................R%
%%%%%%%%%%%%%%%%%%%%%%%%%%%%%%%%%%%%%%
