%%%%%%%%%%%%%%%%%%%%%%%%%%%%%%%%%%%%
%.................................R%
%.%%%%%%%%%%%%%%%%%%%%%%%.%%%%%%%%.%
%.%%...%...%......%%%%%%%...%%.....%
%.%%.%.%.%.%.%%%%.%%%%%%%%%.%%.%%%%%
%.%%.%.%.%.%.............%%.%%.....%
%.%%.%.%.%.%.%.%%%%..%%%....%%%%%%.%
%.%..%.%.%...%....%%.%%%%%%%%......%
%.%%.%.%.%%%%%%%%.%%........%%.%%%%%
%.%%.%...%%.......%%%%%%%%%.%%.....%
%B...%%%%%%.%%%%%%%......%%.%%%%%%.%
%%%%%%......%.......%%%%.%%.%......%
%......%%%%%%.%%%%%.%....%%.%%.%%%%%
%.%%%%%%......%.......%%%%%.%%.....%
%........%%%%%%.%%%%%%%%%%%.%%..%%.%
%%%%%%%%%%..................%%%%%%.%
%..........%%%%%%%%%%%%%%%%........%
%%%%%%%%%%%%%%%%%%%%%%%%%%%%%%%%%%%%
