%%%%%%%%%%%%%%%%%%%%%
%.                  %
%     %%%%      %% R% 
%    %% .%%    .%%  %
%    %    %         %
%   %%    %%    %%  %
%         .%    %%  % 
%  %%%%%%% %%   %%  %  
%  %            %%  %  
% %%        %%  %%  %  
% %         .%  %%  % 
%.                  %
%%%%%%%%%%%%%%%%%%%%%
