%%%%%%%%%%%%%%%%%%%%%%%%%%%%%%%%%%%%%%
%                                   R%
%     %%%%     %%%       % %       % %
%    %%  %%    %%%%      % %       % %
%   .%    %   .%  %%     % %       % %
%   %%    %%   %   %%    % %       % %
%   %      %   %    %%   % %       % %
%  %%%%%%%%%%  %     %%. % %       % %
%  %        %  %      %% % %       % %
% %%        %% %       %%% %%    .%% %
% %          % %        %%  %%%%%%%  %
%.                                  .%
%%%%%%%%%%%%%%%%%%%%%%%%%%%%%%%%%%%%%%
